10
20
WWWWWWWWWWWWWWWWWWWW
WPAAAAAAAAAAAAAAAAAW
WAAAAAAAAAAAAAAAAAAW
WAAAAAAAAAAAAAAAAAAW
WAAAAAAAAAAAAAAAAAAW
WAAAAAAAAAAAAAAAAAAW
WAAAAAAAAAAAAAAAAAAW
WAAAAAAAAAAAAAAAAAAW
WAAAAAAAAAAAAAAAAAMW
WWWWWWWWWWWWWWWWWWWW
