10
20
WWWWWWWWWWWWWWWWWWWW
WPGGGGGGGSGGGGGGGGSW
WGGGGGGGGGGGGGGGGGGW
WSGGGGGGGSGGGGGGGGSW
WGGGGGGGGGGGGGGGGGGW
WSGGGGGGGSGGGGGGGGSW
WGGGGGGGGGGGGGGGGGGW
WGGGGGGGGGGGGGGGGGSW
WGGGGGGGGGGGGGGGGGMW
WWWWWWWWWWWWWWWWWWWW
