20
20
WWWWWWWWWWWWWWWWWWWW
WWWWWWWGGPGGWWWWWWWW
WWWWWWWGGGGGWWWWWWWW
WWWWWWWGAGGGWWWWWWWW
WWWWWWWGGGGGWWWWWWWW
WWWWWWWGGAGGWWWWWWWW
WWWWWWWGAGAGWWWWWWWW
WWWWWWWGGAGGWWWWWWWW
WWWWWWWGGGGGWWWWWWWW
WWWWWWWGGAGGWWWWWWWW
WWWWWWWGAGGGWWWWWWWW
WWWWWWWGGAGGWWWWWWWW
WWWWWWWGAGAGWWWWWWWW
WWWWWWWGAGGGWWWWWWWW
WWWWWWWGGAGGWWWWWWWW
WWWWWWWGAGGGWWWWWWWW
WWWWWWWGGGAGWWWWWWWW
WWWWWWWGAGGGWWWWWWWW
WWWWWWWGGMGGWWWWWWWW
WWWWWWWWWWWWWWWWWWWW
