10
20
WWWWWWWWWWWWWWWWWWWW
WGGGGGGGGGGGWGGGGGGW
WGGGGGGGGPGGGGGGGGGW
WWGGGGGGGGGGGGGGGGGW
WNGGGGGGGGGGGGGGGGNW
WGGWGGGGGGGGGGGGGGGW
WGGNGGGGNWGGGGGGGGGW
WGWNGGGGGGGGGGGGGGGW
WNGGGGGGNGGWGGGGGGGW
WWWWWWWWWWWWWWWWWWWW
