10
20
WWWWWWWWWWWWWWWWWWWW
WPGGGGGGGGGGGGGGGGGW
WWWWWWWWWWWWWWWWWWGW
WWWWWWWWWGGGGGGGGGGW
WWGGGGGGGGWWWWWWWWWW
WWGWWWWWWWWWWWWWWWWW
WWGGGGGWWWWWWWWWWWWW
WWWWWWGGGGGGGGGWWWWW
WWWWWWWWWWWWWWGGGGMW
WWWWWWWWWWWWWWWWWWWW
