10
20
WWWWWWWWWWWWWWWWWWWW
WPGGGGGGGGGGGSGGGGGW
WWWWWWWWWGWWWGWWWWWW
WGSGGGGGGGGGGGGGGGGW
WWGGWWWWWWWWWWWWWWWW
WGGGGGGGGGGGGGGGSGGW
WWWWWWWWWWWWWWWWGWWW
WMGGGGGGGGGGGGGGGGGW
WWWWWWWWWWWWWWWWWWWW
WWWWWWWWWWWWWWWWWWWW
