10
20
WWWWWWWWWWWWWWWWWWWW
WWWWWWGGGPGGGWWWWWWW
WWWWWWGSSSGGGWWWWWWW
WWWWWWGSGGGGGWWWWWWW
WWWWWWGSSSSSGWWWWWWW
WWWWWWGGGGGSGWWWWWWW
WWWWWWGGGMSSGWWWWWWW
WWWWWWWWWWWWWWWWWWWW
WWWWWWWWWWWWWWWWWWWW
WWWWWWWWWWWWWWWWWWWW