10
20
WWWWWWWWWWWWWWWWWWWW
WPGGGGGGGGGGGGGGGGGW
WWWWWWWWWWWWWWWWWWGW
WGGGGGGGGGGGGGGGGGGW
WGWWWWWWWWWWWWWWWWWW
WGGGGGGGGGGGGGGGGGGW
WWWWWWWWWWWWWWWWWWGW
WMGGGGGGGGGGGGGGGGGW
WWWWWWWWWWWWWWWWWWWW
WWWWWWWWWWWWWWWWWWWW