10
20
WWWWWWWWWWWWWWWWWWWW
WPGGGGGGGGGGGGGGGGSW
WWWWWWWWWWWWWWWWWWGW
WWWSGGGGGGGWWWWWWWGW
WWWGWWWWWWGWWWWWWWGW
WWWGWWWWWWMWWWWWWWGW
WWWGWWWWWWWWWWWWWWGW
WWWSGGGGGGGGGGGGGGSW
WWWWWWWWWWWWWWWWWWWW
WWWWWWWWWWWWWWWWWWWW