10
20
WWWWWWWWWWWWWWWWWWWW
WWWWWWWWWWWWWWWWWWWW
WWWGMSGGGGSGGGGGGWWW
WWWGGGGGGPGGGGGGGWWW
WWWGGGGGGGGGGGGGGWWW
WWWGGSGGGSGGGGGGGWWW
WWWGGGGGGGSGGGSGGWWW
WWWGSGGGGGGGGGSGGWWW
WWWWWWWWWWWWWWWWWWWW
WWWWWWWWWWWWWWWWWWWW