10
20
WWWWWWWWWWWWWWWWWWWW
WPGGGGGGGGGGGGGGGGGW
WWWWWWWWWWWWWWWWWWGW
WGGGGGGGGGGGGGGGGWGW
WGWWWWWWWWWWWWWWGWGW
WGWSGGGGGGGGGGMWGWGW
WGWSGGGGGGGGGGGGGWGW
WGWWWWWWWWWWWWWWWWGW
WGGGGGGGGGGGGGGGGGGW
WWWWWWWWWWWWWWWWWWWW