10
20
WWWWWWWWWWWWWWWWWWWW
WWWWSWWWWSWWWSWWWSWW
WWWWGWWWWGWWWGWWWGWW
WWWWGWWWWGWWWGWWWGWW
WGPGGGGGGGGGGGGGGGMW
WWWWWWGWWWWGWWWGWWWW
WWWWWWGWWWWGWWWGWWWW
WWWWWWSWWWWSWWWSWWWW
WWWWWWWWWWWWWWWWWWWW
WWWWWWWWWWWWWWWWWWWW